1111111111111
1000010010001
1000N00000001
1111100111111