1111111111111
1000010010001
100000000001
1111100111111
    1111     