1111111111111
1000010010001
10000N0000011
1111100111111
    1111     