1111111111111
1000010010001
1000N000     
1111100111111
    111111   
